11111111111111
1E1111011011C1
1001C011000101
11000000010101
10101101010001
10000000000101
100110010000P1
11111111111111