111111111111111111111111111111111
10000000000000C0P00000000000000E1
111111111111111111111111111111111